##################
#roygbp          #
#                #
#                #
#                #
#                #
#                #
#                #
#                #
#                #
#                #
#                #
#               +#
##################