##############
#roygbp      #
#            #
#            #
#            #
#            #
#            #
#           +#
##############