##############
#            #
# w   b      #
# w   b      #
#            #
##  b   w    #
##  b   w    #
##  x   x   +#
##############