##############
#            #
######bb######
#    #  #    #
#    #  #    #
#    #       #
#    #bb#    #
#    #xx#   +#
##############