##############
#            #
#            #
# b w w b w  #
# b w w b w  #
# b w w b w  #
## w b b w bw#
##xxxxxxxxx +#
##############