##############
# ###   #    # 
#b###b#w#wbwb#
#w###w#b#b   #
#b###b#w#w   #
#w   w#b b   #
#bwwwb#wbw   #
#xxxxxxxxxxx+#
##############