##############
#            #
#            #
#            #
#            #
#            #
#####www##bbb#
#xxxxxxxxxxx+#
##############