##############
#      wb    #
#     bw     #
#    wb      #
#   bw       #
#  wb        #
# bw         #
#wbxxxxxx   +#
##############