##############
#            #
#bwbwbwbwbwbw#
#xxxxxxxxxx b#
#           w#
#wbwbwbwbwbwb#
#wxxxxxxxxxxx#
#w          +#
##############