##############
#            #
#b#wwwwww#   #
#w#xxxxxx#   #
#b########   #
#wbbbbbbb#   #
########w#   #
# bbbbbbb#  +#
##############