##############
#     #      #
## ##b#      #
##w##w#      #
## ##b#      #
##b##w       #
## ##b#      #
# w##x#     +#
##############